Club,MP,W,D,L,GF,GA,GD,Pts
Manchester City, 38, 27, 6, 5, 83, 32, 51, 87
Manchester United, 38, 21, 11, 6, 73, 44, 29, 74
Liverpool, 38, 20, 9, 9, 67, 30, 37, 69
Chelsea, 38, 19, 10, 9, 58, 36, 22, 67
Leicester City, 38, 20, 6, 12, 68, 50, 18, 66
West Ham United, 38, 19, 8, 11, 62, 47, 15, 65
Tottenham Hotspur, 38, 18, 8, 12, 68, 47, 21, 62
Arsenal, 38, 18, 7, 13, 55, 39, 16, 61
Leeds United, 38, 18, 5, 15, 62, 54, 8, 59
Everton, 38, 17, 8, 13, 47, 48, -1, 59